#+ added taxa
#- removed taxa
#! changes

+Dehalococcoides_mccartyi_CP000027_TS	k__Bacteria; p__Chloroflexi; c__Dehalococcoidia; o__Dehalococcoidales; f__Dehalococcoidaceae; g__Dehalococcoides; s__Dehalococcoides_mccartyi
+Clavibacter_michiganensis_NC_020891.1_TS	k__Bacteria; p__Actinobacteria; c__Actinobacteria; o__Micrococcales; f__Microbacteriaceae; g__Clavibacter; s__Clavibacter_michiganensis
+Lactobacillus_casei_AB008212	k__Bacteria; p__Firmicutes; c__Bacilli; o__Lactobacillales; f__Lactobacillaceae; g__Lactobacillus; s__Lactobacillus_casei
+Streptococcus_thermophilus_AY188354_TS	k__Bacteria; p__Firmicutes; c__Bacilli; o__Lactobacillales; f__Streptococcaceae; g__Streptococcus; s__Streptococcus_thermophilus
+Lactobacillus_zeae_AB008213	k__Bacteria; p__Firmicutes; c__Bacilli; o__Lactobacillales; f__Lactobacillaceae; g__Lactobacillus; s__Lactobacillus_zeae
+Clavibacter_michiganensis_AM410695_TS	k__Bacteria; p__Actinobacteria; c__Actinobacteria; o__Micrococcales; f__Microbacteriaceae; g__Clavibacter; s__Clavibacter_michiganensis
+Gulosibacter_chungangensis_HQ268603_TS	k__Bacteria; p__Actinobacteria; c__Actinobacteria; o__Micrococcales; f__Microbacteriaceae; g__Gulosibacter; s__Gulosibacter_chungangensis
+Clavibacter_michiganensis_LQXA01000018_TS	k__Bacteria; p__Actinobacteria; c__Actinobacteria; o__Micrococcales; f__Microbacteriaceae; g__Clavibacter; s__Clavibacter_michiganensis
+Clavibacter_michiganensis_U09762_TS	k__Bacteria; p__Actinobacteria; c__Actinobacteria; o__Micrococcales; f__Microbacteriaceae; g__Clavibacter; s__Clavibacter_michiganensis
+Clavibacter_michiganensis_U30254_TS	k__Bacteria; p__Actinobacteria; c__Actinobacteria; o__Micrococcales; f__Microbacteriaceae; g__Clavibacter; s__Clavibacter_michiganensis
+Acidipropionibacterium_virtanenii_MG596783_TS	k__Bacteria; p__Actinobacteria; c__Actinobacteria; o__Propionibacteriales; f__Propionibacteriaceae; g__Acidipropionibacterium; s__Acidipropionibacterium_virtanenii
+Microbacterium_gubbeenense_AUGQ01000013_TS	k__Bacteria; p__Actinobacteria; c__Actinobacteria; o__Micrococcales; f__Microbacteriaceae; g__Microbacterium; s__Microbacterium_gubbeenense
+Lactobacillus_casei_AP012544.1_TS	k__Bacteria; p__Firmicutes; c__Bacilli; o__Lactobacillales; f__Lactobacillaceae; g__Lactobacillus; s__Lactobacillus_casei
+Lactobacillus_casei_AP012544.2_TS	k__Bacteria; p__Firmicutes; c__Bacilli; o__Lactobacillales; f__Lactobacillaceae; g__Lactobacillus; s__Lactobacillus_casei
+Lactobacillus_casei_AP012544.3_TS	k__Bacteria; p__Firmicutes; c__Bacilli; o__Lactobacillales; f__Lactobacillaceae; g__Lactobacillus; s__Lactobacillus_casei
+Lactobacillus_casei_BALS01000143	k__Bacteria; p__Firmicutes; c__Bacilli; o__Lactobacillales; f__Lactobacillaceae; g__Lactobacillus; s__Lactobacillus_casei
+Klebsiella_grimontii_GB_GCA_003261555.1	k__Bacteria; p__Proteobacteria; c__Gammaproteobacteria; o__Enterobacteriales; f__Enterobacteriaceae; g__Klebsiella; s__Klebsiella_grimontii
+Klebsiella_aerogenes_RS_GCF_000215745.1_TS	k__Bacteria; p__Proteobacteria; c__Gammaproteobacteria; o__Enterobacteriales; f__Enterobacteriaceae; g__Klebsiella; s__Klebsiella_aerogenes
+Klebsiella_variicola_AJ783916_TS	k__Bacteria; p__Proteobacteria; c__Gammaproteobacteria; o__Enterobacteriales; f__Enterobacteriaceae; g__Klebsiella; s__Klebsiella_variicola
+Klebsiella_pneumoniae_X87276_TS	k__Bacteria; p__Proteobacteria; c__Gammaproteobacteria; o__Enterobacteriales; f__Enterobacteriaceae; g__Klebsiella; s__Klebsiella_pneumoniae
+Klebsiella_aerogenes_KC429778_TS	k__Bacteria; p__Proteobacteria; c__Gammaproteobacteria; o__Enterobacteriales; f__Enterobacteriaceae; g__Klebsiella; s__Klebsiella_aerogenes
+Brachyspira_murdochii_RS_GCF_000092845.1	k__Bacteria; p__Spirochaetota; c__Brachyspirae; o__Brachyspirales; f__Brachyspiraceae; g__Brachyspira; s__Brachyspira_murdochii
+Brachyspira_intermedia_RS_GCF_000223215.1	k__Bacteria; p__Spirochaetota; c__Brachyspirae; o__Brachyspirales; f__Brachyspiraceae; g__Brachyspira; s__Brachyspira_intermedia
+Brachyspira_hampsonii_RS_GCF_000316195.1	k__Bacteria; p__Spirochaetota; c__Brachyspirae; o__Brachyspirales; f__Brachyspiraceae; g__Brachyspira; s__Brachyspira_hampsonii
+Brachyspira_pilosicoli_RS_GCF_000325665.1	k__Bacteria; p__Spirochaetota; c__Brachyspirae; o__Brachyspirales; f__Brachyspiraceae; g__Brachyspira; s__Brachyspira_pilosicoli
+Brachyspira_innocens_RS_GCF_000384655.1	k__Bacteria; p__Spirochaetota; c__Brachyspirae; o__Brachyspirales; f__Brachyspiraceae; g__Brachyspira; s__Brachyspira_innocens
+Brachyspira_alvinipulli_RS_GCF_000518245.1	k__Bacteria; p__Spirochaetota; c__Brachyspirae; o__Brachyspirales; f__Brachyspiraceae; g__Brachyspira; s__Brachyspira_alvinipulli
+Brachyspira_hyodysenteriae_RS_GCF_001676785.2	k__Bacteria; p__Spirochaetota; c__Brachyspirae; o__Brachyspirales; f__Brachyspiraceae; g__Brachyspira; s__Brachyspira_hyodysenteriae
+Brachyspira_hampsonii_RS_GCF_001746205.1	k__Bacteria; p__Spirochaetota; c__Brachyspirae; o__Brachyspirales; f__Brachyspiraceae; g__Brachyspira; s__Brachyspira_hampsonii
+Brachyspira_hampsonii_RS_GCF_001746225.1_TS	k__Bacteria; p__Spirochaetota; c__Brachyspirae; o__Brachyspirales; f__Brachyspiraceae; g__Brachyspira; s__Brachyspira_hampsonii
+Enterococcus_silesiacus_RS_GCF_001886195.1	k__Bacteria; p__Firmicutes; c__Bacilli; o__Lactobacillales; f__Enterococcaceae; g__Enterococcus; s__Enterococcus_silesiacus
+Enterococcus_rotai_RS_GCF_001886195.1	k__Bacteria; p__Firmicutes; c__Bacilli; o__Lactobacillales; f__Enterococcaceae; g__Enterococcus; s__Enterococcus_rotai
+Enterococcus_dispar_RS_GCF_000407365.1	k__Bacteria; p__Firmicutes; c__Bacilli; o__Lactobacillales; f__Enterococcaceae; g__Enterococcus; s__Enterococcus_dispar
+Enterococcus_caccae_RS_GCF_000407365.1	k__Bacteria; p__Firmicutes; c__Bacilli; o__Lactobacillales; f__Enterococcaceae; g__Enterococcus; s__Enterococcus_caccae
+Enterococcus_haemoperoxidus_RS_GCF_000407565.1	k__Bacteria; p__Firmicutes; c__Bacilli; o__Lactobacillales; f__Enterococcaceae; g__Enterococcus; s__Enterococcus_haemoperoxidus
+Enterococcus_villorum_RS_GCF_900104595.1	k__Bacteria; p__Firmicutes; c__Bacilli; o__Lactobacillales; f__Enterococcaceae; g__Enterococcus; s__Enterococcus_villorum
+Enterococcus_saccharolyticus_RS_GCF_001886195.1	k__Bacteria; p__Firmicutes; c__Bacilli; o__Lactobacillales; f__Enterococcaceae; g__Enterococcus; s__Enterococcus_saccharolyticus
+Enterococcus_asini_RS_GCF_000407365.1	k__Bacteria; p__Firmicutes; c__Bacilli; o__Lactobacillales; f__Enterococcaceae; g__Enterococcus; s__Enterococcus_asini
+Enterococcus_moraviensis_RS_GCF_001544275.1	k__Bacteria; p__Firmicutes; c__Bacilli; o__Lactobacillales; f__Enterococcaceae; g__Enterococcus; s__Enterococcus_moraviensis
+Enterococcus_pallens_RS_GCF_001544275.1	k__Bacteria; p__Firmicutes; c__Bacilli; o__Lactobacillales; f__Enterococcaceae; g__Enterococcus; s__Enterococcus_pallens
+Enterococcus_phoeniculicola_RS_GCF_001885945.1	k__Bacteria; p__Firmicutes; c__Bacilli; o__Lactobacillales; f__Enterococcaceae; g__Enterococcus; s__Enterococcus_phoeniculicola
+Enterococcus_cecorum_RS_GCF_000407365.1	k__Bacteria; p__Firmicutes; c__Bacilli; o__Lactobacillales; f__Enterococcaceae; g__Enterococcus; s__Enterococcus_cecorum
+Enterococcus_sulfureus_RS_GCF_002947535.1	k__Bacteria; p__Firmicutes; c__Bacilli; o__Lactobacillales; f__Enterococcaceae; g__Enterococcus; s__Enterococcus_sulfureus
+Enterococcus_massiliensis_RS_GCF_001050095.1	k__Bacteria; p__Firmicutes; c__Bacilli; o__Lactobacillales; f__Enterococcaceae; g__Enterococcus; s__Enterococcus_massiliensis
+Enterococcus_canis_RS_GCF_000407365.1	k__Bacteria; p__Firmicutes; c__Bacilli; o__Lactobacillales; f__Enterococcaceae; g__Enterococcus; s__Enterococcus_canis
+Enterococcus_pernyi_RS_GCF_001601555.1	k__Bacteria; p__Firmicutes; c__Bacilli; o__Lactobacillales; f__Enterococcaceae; g__Enterococcus; s__Enterococcus_pernyi
+Enterococcus_ureasiticus_RS_GCF_900104595.1	k__Bacteria; p__Firmicutes; c__Bacilli; o__Lactobacillales; f__Enterococcaceae; g__Enterococcus; s__Enterococcus_ureasiticus
+Enterococcus_plantarum_RS_GCF_001885945.1	k__Bacteria; p__Firmicutes; c__Bacilli; o__Lactobacillales; f__Enterococcaceae; g__Enterococcus; s__Enterococcus_plantarum
+Enterococcus_termitis_RS_GCF_002947535.1	k__Bacteria; p__Firmicutes; c__Bacilli; o__Lactobacillales; f__Enterococcaceae; g__Enterococcus; s__Enterococcus_termitis
+Enterococcus_ureilyticus_RS_GCF_900104595.1	k__Bacteria; p__Firmicutes; c__Bacilli; o__Lactobacillales; f__Enterococcaceae; g__Enterococcus; s__Enterococcus_ureilyticus
+Enterococcus_quebecensis_RS_GCF_001885945.1	k__Bacteria; p__Firmicutes; c__Bacilli; o__Lactobacillales; f__Enterococcaceae; g__Enterococcus; s__Enterococcus_quebecensis
+Enterococcus_rivorum_RS_GCF_001886195.1	k__Bacteria; p__Firmicutes; c__Bacilli; o__Lactobacillales; f__Enterococcaceae; g__Enterococcus; s__Enterococcus_rivorum
+Enterococcus_canintestini_RS_GCF_000407365.1	k__Bacteria; p__Firmicutes; c__Bacilli; o__Lactobacillales; f__Enterococcaceae; g__Enterococcus; s__Enterococcus_canintestini
+Enterococcus_hermanniensis_RS_GCF_000407565.1	k__Bacteria; p__Firmicutes; c__Bacilli; o__Lactobacillales; f__Enterococcaceae; g__Enterococcus; s__Enterococcus_hermanniensis
+Enterococcus_wangshanyuanii_RS_GCF_900104595.1	k__Bacteria; p__Firmicutes; c__Bacilli; o__Lactobacillales; f__Enterococcaceae; g__Enterococcus; s__Enterococcus_wangshanyuanii
+Enterococcus_timonensis_RS_GCF_900104595.1	k__Bacteria; p__Firmicutes; c__Bacilli; o__Lactobacillales; f__Enterococcaceae; g__Enterococcus; s__Enterococcus_timonensis
+Raoultella_planticola_RS_GCF_000735435.1	k__Bacteria; p__Proteobacteria; c__Gammaproteobacteria; o__Enterobacteriales; f__Enterobacteriaceae; g__Raoultella; s__Raoultella_planticola
+Raoultella_terrigena_RS_GCF_000964285.1	k__Bacteria; p__Proteobacteria; c__Gammaproteobacteria; o__Enterobacteriales; f__Enterobacteriaceae; g__Raoultella; s__Raoultella_terrigena
+Lactobacillus_oeni_AY681127_TS	k__Bacteria; p__Firmicutes; c__Bacilli; o__Lactobacillales; f__Lactobacillaceae; g__Lactobacillus; s__Lactobacillus_oeni
+Lactococcus_lactis_AB008214_TS	k__Bacteria; p__Firmicutes; c__Bacilli; o__Lactobacillales; f__Streptococcaceae; g__Lactococcus; s__Lactococcus_lactis
+Lactococcus_lactis_AB008215_TS	k__Bacteria; p__Firmicutes; c__Bacilli; o__Lactobacillales; f__Streptococcaceae; g__Lactococcus; s__Lactococcus_lactis
+Lactococcus_lactis_EF694031_TS	k__Bacteria; p__Firmicutes; c__Bacilli; o__Lactobacillales; f__Streptococcaceae; g__Lactococcus; s__Lactococcus_lactis
+Lactococcus_lactis_ET770697_TS	k__Bacteria; p__Firmicutes; c__Bacilli; o__Lactobacillales; f__Streptococcaceae; g__Lactococcus; s__Lactococcus_lactis
+Tetragenococcus_halophilus_AJ301843_TS	k__Bacteria; p__Firmicutes; c__Bacilli; o__Lactobacillales; f__Enterococcaceae; g__Tetragenococcus; s__Tetragenococcus_halophilus
+Tetragenococcus_halophilus_ET522087_TS	k__Bacteria; p__Firmicutes; c__Bacilli; o__Lactobacillales; f__Enterococcaceae; g__Tetragenococcus; s__Tetragenococcus_halophilus
+Lactobacillus_gallinarum_AJ242968_TS	k__Bacteria; p__Firmicutes; c__Bacilli; o__Lactobacillales; f__Lactobacillaceae; g__Lactobacillus; s__Lactobacillus_gallinarum
+Lactobacillus_helveticus_AM113779	k__Bacteria; p__Firmicutes; c__Bacilli; o__Lactobacillales; f__Lactobacillaceae; g__Lactobacillus; s__Lactobacillus_helveticus
+Lactobacillus_helveticus_AB008210_TS	k__Bacteria; p__Firmicutes; c__Bacilli; o__Lactobacillales; f__Lactobacillaceae; g__Lactobacillus; s__Lactobacillus_helveticus

-Sulfuritalea_hydrogenivorans_JX470445	k__Bacteria; p__Proteobacteria; c__Alphaproteobacteria; o__Rhizobiales; f__Sterolibacteriaceae; g__Sulfuritalea; s__Sulfuritalea_hydrogenivorans
-Caldithrix_abyssi_GU584665	k__Bacteria; p__Deferribacteres; c__Deferribacteres; o__Deferribacterales; f__Deferribacteraceae; g__Caldithrix; s__Caldithrix_abyssi
-Lactobacillus_gallinarum_AB008208_TS	k__Bacteria; p__Firmicutes; c__Bacilli; o__Lactobacillales; f__Lactobacillaceae; g__Lactobacillus; s__Lactobacillus_gallinarum
-Dehalococcoides_mccartyi_AM943582	k__Bacteria; p__Chloroflexi; c__Dehalococcoidia; o__Dehalococcoidales; f__Dehalococcoidaceae; g__Dehalococcoides; s__Dehalococcoides_mccartyi
-Dehalogenimonas_lykanthroporepellens_CP000027_TS	k__Bacteria; p__Chloroflexi; c__Dehalococcoidia; o__Dehalococcoidales; f__Dehalococcoidaceae; g__Dehalogenimonas; s__Dehalogenimonas_lykanthroporepellens
-Lactobacillus_helveticus_AB680751_TS	k__Bacteria; p__Firmicutes; c__Bacilli; o__Lactobacillales; f__Lactobacillaceae; g__Lactobacillus; s__Lactobacillus_helveticus
-Aciditerrimonas_ferrireducens_FM209057	k__Bacteria; p__Actinobacteria; c__Acidimicrobiia; o__Acidimicrobiales; f__Acidimicrobiaceae; g__Aciditerrimonas; s__Aciditerrimonas_ferrireducens
-Burkholderiales_Species_JF116563	k__Bacteria; p__Proteobacteria; c__Betaproteobacteria; o__Burkholderiales; f__Burkholderiales_Family; g__Burkholderiales_Genus; s__Burkholderiales_Species
-Clavibacter_michiganensis_AM410697_TS	k__Bacteria; p__Actinobacteria; c__Actinobacteria; o__Micrococcales; f__Microbacteriaceae; g__Clavibacter; s__Clavibacter_michiganensis
-Klebsiella_variicola_AF250285_TS	k__Bacteria; p__Proteobacteria; c__Gammaproteobacteria; o__Enterobacteriales; f__Enterobacteriaceae; g__Klebsiella; s__Klebsiella_variicola
-Klebsiella_pneumoniae_AB004753_TS	k__Bacteria; p__Proteobacteria; c__Gammaproteobacteria; o__Enterobacteriales; f__Enterobacteriaceae; g__Klebsiella; s__Klebsiella_pneumoniae
-Paenibacillus_macerans_AUGQ01000022	k__Bacteria; p__Firmicutes; c__Bacilli; o__Bacillales; f__Paenibacillaceae; g__Paenibacillus; s__Paenibacillus_macerans
-Lactobacillus_casei_AB008212_TS	k__Bacteria; p__Firmicutes; c__Bacilli; o__Lactobacillales; f__Lactobacillaceae; g__Lactobacillus; s__Lactobacillus_casei
-Streptococcus_salivarius_AY188354_TS	k__Bacteria; p__Firmicutes; c__Bacilli; o__Lactobacillales; f__Streptococcaceae; g__Streptococcus; s__Streptococcus_salivarius
-Lactobacillus_zeae_AB008213_TS	k__Bacteria; p__Firmicutes; c__Bacilli; o__Lactobacillales; f__Lactobacillaceae; g__Lactobacillus; s__Lactobacillus_zeae
-Lactobacillus_casei_AZCO01000108_TS	k__Bacteria; p__Firmicutes; c__Bacilli; o__Lactobacillales; f__Lactobacillaceae; g__Lactobacillus; s__Lactobacillus_casei
-Lactobacillus_gallinarum_AZEL01000036_TS	k__Bacteria; p__Firmicutes; c__Bacilli; o__Lactobacillales; f__Lactobacillaceae; g__Lactobacillus; s__Lactobacillus_gallinarum
-Lactobacillus_helveticus_AZEK01000173_TS	k__Bacteria; p__Firmicutes; c__Bacilli; o__Lactobacillales; f__Lactobacillaceae; g__Lactobacillus; s__Lactobacillus_helveticus

! Dehalococcoides_mccartyi_AM943582	k__Bacteria; p__Chloroflexi; c__Dehalococcoidia; o__Dehalococcoidales; f__Dehalococcoidaceae; g__Dehalococcoides; s__Dehalococcoides_mccartyi
! Dehalogenimonas_lykanthroporepellens_CP000027_TS	k__Bacteria; p__Chloroflexi; c__Dehalococcoidia; o__Dehalococcoidales; f__Dehalococcoidaceae; g__Dehalogenimonas; s__Dehalogenimonas_lykanthroporepellens
! Dehalococcoides_mccartyi_CP000027_TS	k__Bacteria; p__Chloroflexi; c__Dehalococcoidia; o__Dehalococcoidales; f__Dehalococcoidaceae; g__Dehalococcoides; s__Dehalococcoides_mccartyi

! Clavibacter_michiganensis_AM410697_TS	k__Bacteria; p__Actinobacteria; c__Actinobacteria; o__Micrococcales; f__Microbacteriaceae; g__Clavibacter; s__Clavibacter_michiganensis
! Clavibacter_michiganensis_NC_020891.1_TS	k__Bacteria; p__Actinobacteria; c__Actinobacteria; o__Micrococcales; f__Microbacteriaceae; g__Clavibacter; s__Clavibacter_michiganensis

! Lactobacillus_casei_AB008212_TS	k__Bacteria; p__Firmicutes; c__Bacilli; o__Lactobacillales; f__Lactobacillaceae; g__Lactobacillus; s__Lactobacillus_casei
! Lactobacillus_casei_AB008212	k__Bacteria; p__Firmicutes; c__Bacilli; o__Lactobacillales; f__Lactobacillaceae; g__Lactobacillus; s__Lactobacillus_casei

! Streptococcus_salivarius_AY188354_TS	k__Bacteria; p__Firmicutes; c__Bacilli; o__Lactobacillales; f__Streptococcaceae; g__Streptococcus; s__Streptococcus_salivarius
! Streptococcus_thermophilus_AY188354_TS	k__Bacteria; p__Firmicutes; c__Bacilli; o__Lactobacillales; f__Streptococcaceae; g__Streptococcus; s__Streptococcus_thermophilus

! Lactobacillus_zeae_AB008213_TS	k__Bacteria; p__Firmicutes; c__Bacilli; o__Lactobacillales; f__Lactobacillaceae; g__Lactobacillus; s__Lactobacillus_zeae
! Lactobacillus_zeae_AB008213	k__Bacteria; p__Firmicutes; c__Bacilli; o__Lactobacillales; f__Lactobacillaceae; g__Lactobacillus; s__Lactobacillus_zeae
